1111111111111111111111111111111111111111111111111
1000000000001000000000000000000000001000000000001
1020202020201020202020202020202020201020202020201
1000000000001000000000000000000000001000000000001
1020111110201020111111111111111110201020111110201
1000100000000000000000000000000000000000000010001
1020102020202020202020202020202020202020202010201
1000100000000000000000000000000000000000000010001
1020102011111020111111000001111110201111102010201
1000100000000000100000000000000010000000000010001
1020102020202020100000000000000010202020202010201
0000000000000000100000000000000010000000000000000
2020202011111020100000000000000010201111102020202
0000000000000000100000000000000010000000000000000
1020102020202020100000000000000010202020202010201
1000100000000000100000000000000010000000000010001
1020102011111020111111111111111110201111102010201
1000100000000000000000000000000000000000000010001
1020102020202020202020202020202020202020202010201
1000100000000000000000000000000000000000000010001
1020111110201020111111111111111110201020111110201
1000000000001000000000000000000000001000000000001
1020202020201020202020202020202020201020202020201
1000000000001000000000000000000000001000000000001
1111111111111111111111111111111111111111111111111