1111111111111111111111111111111111111111111111111
1000000000001000000000000000000000001000000000001
1000000000001000000000000000000000001000000000001
1000000000001000000000000000000000001000000000001
1000111110001000111111111111111110001000111110001
1000100000000000000000000000000000000000000010001
1000100000000000000000000000000000000000000010001
1000100000000000000000000000000000000000000010001
1000100011111000111111000001111110001111100010001
1000100000000000100000000000000010000000000010001
1000100000000000100000000000000010000000000010001
0000000000000000100000000000000010000000000000000
0000000011111000100000000000000010001111100000000
0000000000000000100000000000000010000000000000000
1000100000000000100000000000000010000000000010001
1000100000000000100000000000000010000000000010001
1000100011111000111111111111111110001111100010001
1000100000000000000000000000000000000000000010001
1000100000000000000000000000000000000000000010001
1000100000000000000000000000000000000000000010001
1000111110001000111111111111111110001000111110001
1000000000001000000000000000000000001000000000001
1000000000001000000000000000000000001000000000001
1000000000001000000000000000000000001000000000001
1111111111111111111111111111111111111111111111111