11111111111111111111111111
10222212222222222212222221
12111212111111111212111121
12122222222222222222221121
12121112111000111211121121
12121112100000001222221121
22222222100000001211121122
12121112100000001222221121
12121112111111111211121121
12122222222222222222221121
12111212111111111212111121
12222212222222222212222221
11111111111111111111111111