11111111111111111111111111
12222212222222222212222221
12111212111111111212111121
12122222222222222222221121
12121112111000111211121121
12122222100000001222221121
22221112100000001211121122
12122222100000001222221121
12121112111111111211121121
12122222222222222222221121
12111212111111111212111121
12222212222222222212222221
11111111111111111111111111