1111111111111111111111111
1022221222222222221222221
1211121211111111121211121
1212222222222222222222121
1212111211100011121112121
1212222210000000122222121
2222111210000000121112222
1212222210000000122222121
1212111211111111121112121
1212222222222222222222121
1211121211111111121211121
1222221222222222221222221
1111111111111111111111111